AA|a,a,a
AE|a,a,a
AH|a,ă,a
AO|o,o,a
AW|au,ao,ao
AY|ai,ai,ai
B|b,b,p
CH|ch,ch,ch
D|đ,đ,t
DH|d,d,
EH|e,e,ê
ER|ơ,ơ,ờ
EY|ây,ê,ây
F|ph,ph,p
G|g,g,ch
HH|h,h,ch
IH|i,i,i
IY|i,i,y
JH|gi,gi,ch
K|c,c,ch
L|l,l,l
M|m,m,m
N|n,n,n
NG|n,ng,ng
OW|ô,ô,ô
OY|oi,oi,oi
P|p,p,p
R|r,r,
S|x,x,t
SH|s,s,t
T|t,t,t
TH|th,t,t
UH|âu,u,u
UW|u,u,u
V|v,v,p
W|gu,,
Y|,i,i
Z|d,d,
ZH|gi,gi,